##############################################################################
NAME:       psy_arrival_fountain
TAGS:       arrival
ORIENT:     float
KMONS:      D = plant
FTILE:      Ttqp{. : floor_grass
SHUFFE:     pq
SUBST:      p = .D, q : .
MAP
xxxxxxxxxxxxx
xtttttttttttx
xt{.........+
xt...tttttqtx
xt....DtDtqtx
xt.t....qtqtx
xt.tt.T...qtx
xt.tD....tttx
xt.ttD.pttttx
xt.ttt.tttttx
xt.pppptttttx
xt.tttttttttx
xx+xxxxxxxxxx
ENDMAP

